NO ./images/brick2.xpm
SO ./images/brick2.xpm
WE ./images/brick2.xpm
EA ./images/brick2.xpm

F  50, 50, 50
C  30, 30, 30

11111111111111111111111111111111111111111111111
10011000011100000111000000000001100000000000001
1011001000000111000D011100111100110011110111101
11100111011111111111111111111111111111010000101
1110011101                           1001000101
1100111001         111      11111111 1000110101
1000010011       111      111    111 1001110001
1000000111     111 111         111   1000110101
1011100011   111  111       111      1100111001
1010000001 11111111111   111         1001110001
1011100101      111    111           1011110011
1011100101     111   11111111111     1011110011
1010101101                           1010100111
10110011011111111111111111111111111111010100111
10111010000010001000100010000000D000001100N1101
10000000001000100000D000000110011000000D0011001
11111111111111111111111111111111111111111111111