NO ./images/kaka.xpm
SO ./images/sama.xpm
WE ./images/blue.xpm
EA ./images/wall.xpm
F  50, 50, 50
C  20, 20, 20
111111111111111111111111111111111
1  110000111000001110000000000011
1 1100100000011100000111001111001
111001110111111111111111100001001
1100111001             1001111001
1000010011      1      1001000011
1000000111     11      1001111001
1011100011    1111     1100000001
1010D00001      1      1001000011
1011100101             1010100111
101000110111111111111111D010011 1
101110100000100010001000000011  1
100000000010D0100010DW1000011  11
111111111111111111111111111111111
