
111111
100101
101001
1100N1
111111        


        1111111111111111111111111
        1000000000110000000000001
        1011000001110000000000001
        1001000000000000000000001
111111111011000001110000000000001
100000000011000001110111111111111
11110111111111011100000010001    
11110111111111011101010010001    
11000000110101011100000010001    
10000000000000001100000010001    
10000000000000001101010010001    
11000001110101011111011110N0111  
11110111 1110101 101111010001    
11111111 1111111 111111111111    


111111111111111111111111111111111
100000000011000000000000000000001
101100000111000000000000000000001
100100000111111111111111000000001
1111111111             1000000001
1000000001             1111111111
1111011111             1100000001    
1111011111             1100000001    
1100000011             1100011111    
1000000001             1010001111
100000000111111111111111100011111    
11000001110101011111011110N011  1  
11110111 1110101 10111101001    1    
111111111111111111111111111111111


        1111111111111111111111111
        1111111111111111111111111
        1011111111101111111111111
        1111111111111111111111111
111111111111111111111111111111111
11111111111111111111111111111
11111111111111111111111111111    
11111111111111S11111111111111    
11111111111111111111111111111    
11111111111111111111111111111    
11111111111111111111111111111    
11111111111111111111111111111  
1111111110111111 110111111111    
1111111111111111 111111111111 


   111111111111111111
 1100000000S0000000011
11100000000000000000111
 11000001111100000011
  111111     1111111

1111111
1001001
1010001
1000101
1001S01
1111111


111111111111111111111111111111111
1  110000111000001110000000000011
1 1100100000011100000111001111001
111001110111111111111111100001001
1100111001             1001111001
1000010011      1      1001000011
1000000111     11      1001111001
1011100011    1111     1100000001
1010000001      1      1001000011
1011100101             1010100111
1010001101111111111111110010011 1
101110100000100010001000S00011  1
10000000001000100010001000011  11
111111111111111111111111111111111

111111111111111111111111111111111
100000000000000000000000000000001
100000000000000000000000000000001
100000000000000000000000000000001
100000000000000000000000000000001
100000000000000000000000000000001
1000000000000000N0000000000000001
100000000000000000000000000000001
100000000000000000000000000000001
100000000000000000000000000000001
100000000000000000000000000000001
100000000000000000000000000000001
100000000000000000000000000000001
100000000000000000000000000000001
111111111111111111111111111111111
