
111111
100101
101001
1100N1
111111        


        1111111111111111111111111
        1000000000110000000000001
        1011000001110000000000001
        1001000000000000000000001
111111111011000001110000000000001
100000000011000001110111111111111
11110111111111011100000010001    
11110111111111011101010010001    
11000000110101011100000010001    
10000000000000001100000010001    
10000000000000001101010010001    
11000001110101011111011110N0111  
11110111 1110101 101111010001    
11111111 1111111 111111111111    


111111111111111111111111111111111
100000000011000000000000000000001
101100000111000000000000000000001
100100000111111111111111000000001
1111111111             1000000001
1000000001             1111111111
1111011111             1100000001    
1111011111             1100000001    
1100000011             1100011111    
1000000001             1010001111
100000000111111111111111100011111    
11000001110101011111011110N011  1  
11110111 1110101 10111101001    1    
111111111111111111111111111111111