NO ./images/kaka.xpm
SO ./images/sama.xpm
WE ./images/blue.xpm
EA ./images/wall.xpm
F  0,225,0
C  173,216,230

 
    
     
      
       
        
111111
100101
101001
1100N1
111111  
 
          
            
    
       
        
         
          
       
     
           
            