NO ./images/kaka.xpm
SO ./images/sama.xpm
WE ./images/blue.xpm
EA ./images/wall.xpm
F  0,225,0
C  157,111,42

 
    
11111111111111111111111111111111111111111111111
10011000011100000111000000000001100000000000001
10110010000001110000011100111100110011110111101
11100111011111111111111111111111111111010000101
1110011101                           1001000101
1100111001         111      11111111 1000110101
1000010011       111      111    111 1001110001
1000000111     111 111         111   1000110101
1011100011   111  111       111      1100111001
1010000001 11111111111   111         1001110001
1011100101      111    111           1011110011
1011100101     111   11111111111     1011110011
1010101101                           1010100111
10110011011111111111111111111111111111010100111
11111010000010001000100010000000000000110001101
1000000000100010000000000N011001100000000011001
11111111111111111111111111111111111111111111111  
 
    
       
        
         
          
       
     
           
            