NO ./images/kaka.xpm
SO ./images/sama.xpm
WE ./images/blue.xpm
EA ./images/wall.xpm
F  0,225,0
C  173,216,230

 
    
     
      
       
        
 
111111111111111111111111111111111
1S0000000011000000000000000000001
101100000111000000000000000000001
100100000111111111111111000000001
1111111111             1000000001
1000000001             1111111111
1111011111             1100000001    
1111011111             1100000001    
1100000011             1100011111    
1000000001             1010001111
100000000111111111111111100011111    
110000011101010111110111100011  1  
11110111 1110101 10111101001    1    
111111111111111111111111111111111
         
 
          
            
    
       
        
         
          
       
     
           
            