
NO ./images/kaka.xpm
SO ./images/sama.xpm
WE ./images/blue.xpm
EA ./images/wall.xpm
F  0,225,0
C  173,216,230

  1111111111111111111
 110000S00000000000011
11100000000000000000111
 11000001111100000011
  1111111   11111111