
NO ./images/a.xpm
SO ./images/aa.xpm
WE ./images/c.xpm
EA ./images/ao.xpm
F  0,225,0
C  0,0,225

                                       
        1111111111111111111111111 
        100000011011000000W000001 
        1011000111000000000000001 
        1001000010000000000000001 
111111111011000001110000000000001 
100000000011000001110111111111111 
11110111111111011100000010001
11110111111111011101010010001    
11000000110101011100000010001    
10000000000000001100000010001    
10000000000000001101010010001    
1100000111010101111101111010111  
11110111 1110101 101111010001    
11111111 1111111 111111111111
                          
 
    
       
