
NO ./images/kaka.xpm
SO ./images/sama.xpm
WE ./images/blue.xpm
EA ./images/wall.xpm
F  0,225,0
C  173,216,230

1111111
1001001
1010001
1000101
1001S01
1111111