111111
100101
101001
1100N1
111111        

1111111
1001001
1010001
1000101
1001S01
1111111

   111111111111111111
 1100000000S000000011
11100000000000000000111
 11000001111100000011
  111111     1111111

        1111111111111111111111111
        1000000000110000000000001
        1011000001110000000000001
        1001000000000000000000001
111111111011000001110000000000001
100000000011000001110111111111111
11110111111111011100000010001    
11110111111111011101010010001    
11000000110101011100000010001    
10000000000000001100000010001    
10000000000000001101010010001    
11000001110101011111011110N0111  
11110111 1110101 101111010001    
11111111 1111111 111111111111    

        1111111111111111111111111
        1111111111111111111111111
        1011111111101111111111111
        1111111111111111111111111
111111111111111111111111111111111
11111111111111111111111111111
11111111111111111111111111111    
11111111111111S11111111111111    
11111111111111111111111111111    
11111111111111111111111111111    
11111111111111111111111111111    
11111111111111111111111111111  
1111111110111111 110111111111    
1111111111111111 111111111111 

111111111111111111111111111111111
100000000011000000000000000000001
101100000111000000000000000000001
100100000111111111111111000000001
1111111111             1000000001
1000000001             1111111111
1111011111             1100000001    
1111011111             1100000001    
1100000011             1100011111    
1000000001             1010001111
100000000111111111111111100011111    
11000001110101011111011110N011  1  
11110111 1110101 10111101001    1    
111111111111111111111111111111111

111111111111111111111111111111111
1  110000111000001110000000000011
1 1100100000011100000111001111001
111001110111111111111111100001001
1100111001             1001111001
1000010011      1      1001000011
1000000111     11      1001111001
1011100011    1111     1100000001
1010000001      1      1001000011
1011100101             1010100111
1010001101111111111111110010011 1
101110100000100010001000S00011  1
10000000001000100010001000011  11
111111111111111111111111111111111

11111111111111111111111111111111111111111111111
10011000011100000111000000000001100000000000D01
10110010000001110000011100111100110011110111101
11100111011111111111111111111111111111010000101
1110011101                           1001000101
1100111001         111      11111111 1000110101
1000010011       111      111    111 1001110001
1000000111     111 111         111   1000110101
1011100011   111  111       111      1100111001
1010D00001 11111111111   111         1001110001
1011100101      111    111           1011110011
1011100101     111   11111111111     1011110011
1010101101                           1010100111
10110011011111111111111111111111111111010100111
1011101000001000100010001000D000100000110001101
100000000010D0100000D00W00011001100000D00011001
11111111111111111111111111111111111111111111111  

11111111111111111111111111111111111111111
1W000010001000001000000010000000001010001
11101010101011101011101110111011101011101
10001000101010101000100000101010000000001
10101110111110101111111010101110111111111
10101010100000000010000010100010100010001
10111011111111111010111110101111111010101
10101010001000001010000010000010100000101
10101010101110111011101011111110111111101
10000010101000001000001010100010001000001
10101010111111101110111110101111101011101
10101000000010000010000000000010000000101
11101010111110111010101011101110111111111
10101010000000100000101000100000100000001
10101110111010111010101111111110101111101
10001000001010001010101000000010000010101
10111011101110101011111011101110111010101
10100010001010101000001000100010001010101
10111010101011101111101011101111101010101
10100010101000101000100000100010101010001
10111010101110101110101011111110111011101
10101010100000101000001000100010001010101
10101110101111111110101111101110101010101
10001000100010000000100010000010101010101
10101011101010101111111110111110111010111
10101010001010100000000000100000100010001
10101011111011111111111110101111111111101
10101000101000001000001000101000001000001
11101110101111111010111110101010111011111
10001000000010000010100010000010100000001
10111111111011101010101111111110111111101
10100000001000001010000010000010001010001
11101010111110111011111010111111101010101
10001010100000100000001010100000100010101
10101110101011101111101110101110111010111
10101000101010000010000010001000000010001
10101011101010111011111111111010111010101
10101000001010101000000000001010001000101
10101111111010101011101111101011101111101
10100000100010001010000000101010000000101
11111111111111111111111111111111111111111

111111111111111
100000100000001
100S0011111111111111111111
10000010000000000000010001
100000100000000000000D0001
10000010000000000000010001
111D1111111D11111111110001
110000110000001      10001
100000010000001      10001
100000010000001      10001
10000000000000111111111D11111111111
10000001000000100000000000000000001
100000010000001000000000000000000011111
110000110000001001110000000000110010001
111111111111111001000000000000010010001
              1000000000000000000010001
              1000000000000000000010001
              10000000000000000000D0001
              1000000000000000000010001
              1000000000000000000010001
              1001000000000000010010001
              1001100000000000110010001
              1000000000000000000010001
              1000000000000000000010001
              1111111111111111111110001
                                  10001
                               11110001111
                               10000000001
   1111111111111               10000000001
   1000000000001               10000000001
   1000000000001               10000000001
   1000000000001               10000000001
   1000000000001               10000000001
   1000000000001               10000000001
   10011111111111111111111     11111D11111
   100D0000000000000000001       100001
   11110000000000000000001       100001
      10000000000000000001       100001
  11111000000000000111D1111111111100001
  1000D00000000000010000000000000000001
  1000100000000000010000000000000000001
  1000100000000000010000000000000000001
  1000111111D11111110000000000000000001
  1000000010001    111D1111111111111111
  1000000010001    100000000001
  1000000010001    100000000001
  1111011110001    100000000001
    10001 10001    100000000001
    10001111111    100000000001
    10000000001    100000000001
    11111100001    111111011111
         110001        10001
          10001        10001
           10001       10001
            10001      11111
             10001
              10001
               10001
                10001111111111111111111111111111111111111
                10000010001000001000000010000000001010001
                11101010101011101011101110111011101011101
                10001000101010101000100000101010000000001
                10101110111110101111111010101110111111111
                10101010100000000010000010100010100010001
                10111011111111111010111110101111111010101
                10101010001000001010000010000010100000101
                10101010101110111011101011111110111111101
                10000010101000001000001010100010001000001
                10101010111111101110111110101111101011101
                10101000000010000010000000000010000000101
                11101010111110111010101011101110111111111
                10101010000000100000101000100000100000001
                10101110111010111010101111111110101111101
                10001000001010001010101000000010000010101
                10111011101110101011111011101110111010101
                10100010001010101000001000100010001010101
                10111010101011101111101011101111101010101
                10100010101000101000100000100010101010001
                10111010101110101110101011111110111011101
                10101010100000101000001000100010001010101
                10101110101111111110101111101110101010101
                10001000100010000000100010000010101010101
                10101011101010101111111110111110111010111
                10101010001010100000000000100000100010001
                10101011111011111111111110101111111111101
                10101000101000001000001000101000001000001
                11101110101111111010111110101010111011111
                10001000000010000010100010000010100000001
                10111111111011101010101111111110111111101
                10100000001000001010000010000010001010001
                11101010111110111011111010111111101010101
                10001010100000100000001010100000100010101
                10101110101011101111101110101110111010111
                10101000101010000010000010001000000010001
                10101011101010111011111111111010111010101
                10101000001010101000000000001010001000101
                1010111111101010101110111110101110111110111111111
                1010000010001000101000000010101000000010D00000001
                1111111111111111111111111111111111111111100000001
                                                        100000001
                                                        100000001
                                                        100000001
                                                        100000001
                                                        111111111