
NO images/1.xpm 
SO ./images/W1.xpm 
WE ./images/W1.xpm
EA ./images/W1.xpm
F  220,100,0
C 225,3           , 0   
                            
  1     1111111111111111111111111
        1000000000110000000000001
        1011000001110000000000001
        1001000000000000000000001
111111111011000001110000000000001
100000000011000001110111111111111
11110111111111011100000010001    
11110111111111011101010010001    
11000000110101011100000010001    
100000000000000011000S0010001    
10000000000000001101010010001    
1100000111010101111101111010111  
11110111 1110101 101111010001    
11111111 1111111 111111111111
         111                    
         101                                    
11111111 1111111 111111111111
 
 
     
     
 	
